1111111111111111111111
1010001011101110101111
1010101111101111111011
1000000CC0000000001111
101110101111001P111011
1111111C11101010001011
1000111011111010111011
1010101011111110101E11
1110111010001010111011
1000C00010101000000001
1111111111111111111111